A	AH
A(2)	EY
BACKWARD	B AE K W ER D
BIN	B IH N
BISCUIT	B IH S K AH T
BRING	B R IH NG
CAN	K AE N
CAN(2)	K AH N
COOKIE	K UH K IY
DRINK	D R IH NG K
FORWARD	F AO R W ER D
FULL	F UH L
GET	G EH T
GET(2)	G IH T
GO	G OW
HALF	HH AE F
HALT	HH AO L T
I	AY
IN	IH N
LEFT	L EH F T
ME	M IY
MEAN	M IY N
MOVE	M UW V
PAPER	P EY P ER
POP	P AA P
RIGHT	R AY T
SODA	S OW D AH
SOFT	S AA F T
SOFT(2)	S AO F T
SPEED	S P IY D
STOP	S T AA P
THE	DH AH
THE(2)	DH IY
THIS	DH IH S
THROW	TH R OW
TRASH	T R AE SH
TURN	T ER N
YOU	Y UW
